<Map>
	<Name>Isometric Test Map 2</Name>
	<Size>20 10</Size>
	<TileSize>64 64</TileSize>
	<TileTextureList>
	    IsoTiles/Sand/sand0
	    IsoTiles/flat1
	    IsoTiles/flat2
	    IsoTiles/height0
	    IsoTiles/height1
	    IsoTiles/Barricades/barricade0
	    IsoTiles/Barricades/barricade1
	    IsoTiles/Barricades/barricade2
	    IsoTiles/Barricades/barricade3
	    IsoTiles/Barricades/barricade4
	    IsoTiles/Barricades/barricade5
	    IsoTiles/Barricades/barricade6
	    IsoTiles/Barricades/barricade7
	    IsoTiles/Barricades/barricade8
	    IsoTiles/Barricades/barricade9
	</TileTextureList>
	<HelperTextures>
		<PickingHelper>IsoTiles/Helpers/picking_aid</PickingHelper>
		<Cursor>IsoTiles/Helpers/cursor</Cursor>
		<SlopeHeightMap>IsoTiles/Helpers/slope_heightmaps</SlopeHeightMap>
	</HelperTextures>
	<SlopeMap>
	    -1 -1 -1 -1 -1 -1 -1 -1 -1 -1
	    -1 -1 -1 -1 -1 -1 -1 -1 -1 -1
	    -1 -1 -1 -1 -1 -1 -1 -1 -1 -1
	    -1 -1 -1 -1 -1 -1 -1 -1 -1 -1
	    -1 -1 -1 -1 -1 -1 -1 -1 -1 -1
	    -1 -1 -1 -1 -1 -1 -1 -1 -1 -1
	    -1 -1 -1 -1 -1 -1 -1 -1 -1 -1
	    -1 -1 -1 -1 -1 -1 -1 -1 -1 -1
	    -1 -1 -1 -1 -1 -1 -1 -1 -1 -1
	    -1 -1 -1 -1 -1 -1 -1 -1 -1 -1
	    -1 -1 -1 -1 -1 -1 -1 -1 -1 -1
	    -1 -1 -1 -1 -1 -1 -1 -1 -1 -1
	    -1 -1 -1 -1 -1 -1 -1 -1 -1 -1
	    -1 -1 -1 -1 -1 -1 -1 -1 -1 -1
	    -1 -1 -1 -1 -1 -1 -1 -1 -1 -1
	    -1 -1 -1 -1 -1 -1 -1 -1 -1 -1
	    -1 -1 -1 -1 -1 -1 -1 -1 -1 -1
	    -1 -1 -1 -1 -1 -1 -1 -1 -1 -1
	    -1 -1 -1 -1 -1 -1 -1 -1 -1 -1
	    -1 -1 -1 -1 -1 -1 -1 -1 -1 -1
	</SlopeMap>
	<TileLayers>
		<Layer>
			<Textures>
				0  0  0  0  0  0  0  0  0  0
				0  0  0  0  0  0  0  0  0  0
				0  0  0  0  0  0  0  0  0  0
				0  0  0  0  0  0  0  0  0  0
				0  0  0  0  0  0  0  0  0  0
				0  0  0  0  0  0  0  0  0  0
				0  0  0  0  0  0  0  0  0  0
				0  0  0  0  0  0  0  0  0  0
				0  0  0  0  0  0  0  0  0  0
				0  0  0  0  0  0  0  0  0  0
				0  0  0  0  0  0  0  0  0  0
				0  0  0  0  0  0  0  0  0  0
				0  0  0  0  0  0  0  0  0  0
				0  0  0  0  0  0  0  0  0  0
				0  0  0  0  0  0  0  0  0  0
				0  0  0  0  0  0  0  0  0  0
				0  0  0  0  0  0  0  0  0  0
				0  0  0  0  0  0  0  0  0  0
				0  0  0  0  0  0  0  0  0  0
				0  0  0  0  0  0  0  0  0  0
			</Textures>
		</Layer>
		<Layer>
			<Textures>
				-1 -1 -1 -1 -1 -1 -1 -1 -1 -1
				-1 -1 -1 -1 -1 -1 -1 -1 -1 -1
				-1 -1 -1 -1 -1 -1 -1 -1 -1 -1
				-1 -1 -1 -1 -1 -1 -1 -1 -1 -1
				-1 -1 -1 -1 -1 -1 -1 -1 -1 -1
				-1 -1 -1 -1 -1 -1 -1 -1 -1 -1
				-1 -1 -1 -1 -1 -1 -1 -1 -1 -1
				-1 -1  3  3 -1 -1 -1 -1 -1 -1
				-1 -1  3  3 -1 -1 -1 -1 -1 -1
				-1 -1 -1 -1 -1 -1 -1 -1 -1 -1
				-1 -1 -1 -1 -1 -1 -1 -1 -1 -1
				-1 -1 -1 -1 -1 -1 -1 -1 -1 -1
				-1 -1 -1 -1 -1 -1 -1 -1 -1 -1
				-1 -1 -1 -1 -1 -1 -1  8 -1 -1
				-1 -1 -1 -1 -1 -1 -1 13 -1 -1
				-1 -1 -1 -1 -1 -1 10 -1 -1 -1
				-1 -1 -1 -1 -1 -1 -1 14 -1 -1
				-1 -1 -1 -1 -1 -1 -1 14 -1 -1
				-1 -1 -1 -1 -1 -1 -1 -1 -1 -1
				-1 -1 -1 -1 -1 -1 -1 -1 -1 -1
			</Textures>
		</Layer>
		<Layer>
			<Textures>
				-1 -1 -1 -1 -1 -1 -1 -1 -1 -1
				-1 -1 -1 -1 -1 -1 -1 -1 -1 -1
				-1 -1 -1 -1 -1 -1 -1 -1 -1 -1
				-1 -1 -1 -1 -1 -1 -1 -1 -1 -1
				-1 -1 -1 -1 -1 -1 -1 -1 -1 -1
				-1 -1 -1 -1 -1 -1 -1 -1 -1 -1
				-1 -1 -1 -1 -1 -1 -1 -1 -1 -1
				-1 -1 -1  4 -1 -1 -1 -1 -1 -1
				-1 -1 -1 -1 -1 -1 -1 -1 -1 -1
				-1 -1 -1 -1 -1 -1 -1 -1 -1 -1
				-1 -1 -1 -1 -1 -1 -1 -1 -1 -1
				-1 -1 -1 -1 -1 -1 -1 -1 -1 -1
				-1 -1 -1 -1 -1 -1 -1 -1 -1 -1
				-1 -1 -1 -1 -1 -1 -1 -1 -1 -1
				-1 -1 -1 -1 -1 -1 -1 -1 -1 -1
				-1 -1 -1 -1 -1 -1 -1 -1 -1 -1
				-1 -1 -1 -1 -1 -1 -1 -1 -1 -1
				-1 -1 -1 -1 -1 -1 -1 -1 -1 -1
				-1 -1 -1 -1 -1 -1 -1 -1 -1 -1
				-1 -1 -1 -1 -1 -1 -1 -1 -1 -1
			</Textures>
		</Layer>
	</TileLayers>
</Map>