<Map>
	<Name>Square Test Map 1</Name>
	<Size>35 39</Size>
	<TileSize>64 64</TileSize>
	<TextureList>
		SqTiles/dirt
		SqTiles/grass
		SqTiles/ground
		SqTiles/mud
		SqTiles/road
		SqTiles/rock
		SqTiles/wood
		SqTiles/foliage
		SqTiles/brick
		SqTiles/dirt2
		SqTiles/ivy
		SqTiles/cobblestone
		SqTiles/rockyterrain
		SqTiles/dungeonwall/dungeonwall_up
		SqTiles/dungeonwall/dungeonwall_urc
		SqTiles/dungeonwall/dungeonwall_down
		SqTiles/dungeonwall/dungeonwall_llc
		SqTiles/dungeonwall/dungeonwall_thin_right
		SqTiles/dungeonwall/dungeonwall_lrc
		SqTiles/dungeonwall/dungeonwall_thin_left
		SqTiles/dungeonwall/dungeonwall_ulc
		SqTiles/stonewall/stonewall_up
		SqTiles/stonewall/stonewall_urc
		SqTiles/stonewall/stonewall_down
		SqTiles/stonewall/stonewall_llc
		SqTiles/stonewall/stonewall_thin_right
		SqTiles/stonewall/stonewall_lrc
		SqTiles/stonewall/stonewall_thin_left
		SqTiles/stonewall/stonewall_ulc
	</TextureList>
	<Layers>
		<Layer>
			<Textures>
				 1  1  1  1  1  1  1  1  1  1  1  1  1  3  3  3  3  3  3  3  3  3  3  3  3  3  2  2  2  2  2  2  2  2  2  2  2  2  2
				 1  1  1  1  1  1  1  1  1  1  1  1  1  3  3  3  3  3  3  3  3  3  3  3  3  3  2  2  2  2  2  2  2  2  2  2  2  2  2
				 1  1  1  1  1  1  1  1  1  1  1  1  1  3  3  3  3  3  3  3  3  3  3  3  3  3  2  2  2  2  2  2  2  2  2  2  2  2  2
				 1  1  1  1  1  1  1  1  1  1  1  1  1  3  3  3  3  3  3  3  3  3  3  3  3  3  2  2  2  2  2  2  2  2  2  2  2  2  2
				 1  1  1  1  1  1  1  1  1  1  1  1  1  3  3  3  3  3  3  3  3  3  3  3  3  3  2  2  2  2  2  2  2  2  2  2  2  2  2
				 1  1  1  1  1  1  1  1  1  1  1  1  1  3  3  3  3  3  3  3  3  3  3  3  3  3  2  2  2  2  2  2  2  2  2  2  2  2  2
				 1  1  1  1  1  1  1  1  1  1  1  1  1  3  3  3  3  3  3  3  3  3  3  3  3  3  2  2  2  2  2  2  2  2  2  2  2  2  2
				 0  0  0  0  0  0  0  0  0  0  0  0  0  5  5  5  5  5  5  5  5  5  5  5  5  5  9  9  9  9  9  9  9  9  9  9  9  9  9
				 0  0  0  0  0  0  0  0  0  0  0  0  0  5  5  5  5  5  5  5  5  5  5  5  5  5  9  9  9  9  9  9  9  9  9  9  9  9  9
				 0  0  0  0  0  0  0  0  0  0  0  0  0  5  5  5  5  5  5  5  5  5  5  5  5  5  9  9  9  9  9  9  9  9  9  9  9  9  9
				 0  0  0  0  0  0  0  0  0  0  0  0  0  5  5  5  5  5  5  5  5  5  5  5  5  5  9  9  9  9  9  9  9  9  9  9  9  9  9
				 0  0  0  0  0  0  0  0  0  0  0  0  0  5  5  5  5  5  5  5  5  5  5  5  5  5  9  9  9  9  9  9  9  9  9  9  9  9  9
				 0  0  0  0  0  0  0  0  0  0  0  0  0  5  5  5  5  5  5  5  5  5  5  5  5  5  9  9  9  9  9  9  9  9  9  9  9  9  9
				 0  0  0  0  0  0  0  0  0  0  0  0  0  5  5  5  5  5  5  5  5  5  5  5  5  5  9  9  9  9  9  9  9  9  9  9  9  9  9
				 7  7  7  7  7  7  7  7  7  7  7  7  7  8  8  8  8  8  8  8  8  8  8  8  8  8  4  4  4  4  4  4  4  4  4  4  4  4  4
				 7  7  7  7  7  7  7  7  7  7  7  7  7  8  8  8  8  8  8  8  8  8  8  8  8  8  4  4  4  4  4  4  4  4  4  4  4  4  4
				 7  7  7  7  7  7  7  7  7  7  7  7  7  8  8  8  8  8  8  8  8  8  8  8  8  8  4  4  4  4  4  4  4  4  4  4  4  4  4
				 7  7  7  7  7  7  7  7  7  7  7  7  7  8  8  8  8  8  8  8  8  8  8  8  8  8  4  4  4  4  4  4  4  4  4  4  4  4  4
				 7  7  7  7  7  7  7  7  7  7  7  7  7  8  8  8  8  8  8  8  8  8  8  8  8  8  4  4  4  4  4  4  4  4  4  4  4  4  4
				 7  7  7  7  7  7  7  7  7  7  7  7  7  8  8  8  8  8  8  8  8  8  8  8  8  8  4  4  4  4  4  4  4  4  4  4  4  4  4
				 7  7  7  7  7  7  7  7  7  7  7  7  7  8  8  8  8  8  8  8  8  8  8  8  8  8  4  4  4  4  4  4  4  4  4  4  4  4  4
				10 10 10 10 10 10 10 10 10 10 10 10 10 11 11 11 11 11 11 11 11 11 11 11 11 11 12 12 12 12 12 12 12 12 12 12 12 12 12
				10 10 10 10 10 10 10 10 10 10 10 10 10 11 11 11 11 11 11 11 11 11 11 11 11 11 12 12 12 12 12 12 12 12 12 12 12 12 12
				10 10 10 10 10 10 10 10 10 10 10 10 10 11 11 11 11 11 11 11 11 11 11 11 11 11 12 12 12 12 12 12 12 12 12 12 12 12 12
				10 10 10 10 10 10 10 10 10 10 10 10 10 11 11 11 11 11 11 11 11 11 11 11 11 11 12 12 12 12 12 12 12 12 12 12 12 12 12
				10 10 10 10 10 10 10 10 10 10 10 10 10 11 11 11 11 11 11 11 11 11 11 11 11 11 12 12 12 12 12 12 12 12 12 12 12 12 12
				10 10 10 10 10 10 10 10 10 10 10 10 10 11 11 11 11 11 11 11 11 11 11 11 11 11 12 12 12 12 12 12 12 12 12 12 12 12 12
				10 10 10 10 10 10 10 10 10 10 10 10 10 11 11 11 11 11 11 11 11 11 11 11 11 11 12 12 12 12 12 12 12 12 12 12 12 12 12
				 6  6  6  6  6  6  6  6  6  6  6  6  6  8  8  8  8  8  8  8  8  8  8  8  8  8  4  4  4  4  4  4  4  4  4  4  4  4  4
				 6  6  6  6  6  6  6  6  6  6  6  6  6  8  8  8  8  8  8  8  8  8  8  8  8  8  4  4  4  4  4  4  4  4  4  4  4  4  4
				 6  6  6  6  6  6  6  6  6  6  6  6  6  8  8  8  8  8  8  8  8  8  8  8  8  8  4  4  4  4  4  4  4  4  4  4  4  4  4
				 6  6  6  6  6  6  6  6  6  6  6  6  6  8  8  8  8  8  8  8  8  8  8  8  8  8  4  4  4  4  4  4  4  4  4  4  4  4  4
				 6  6  6  6  6  6  6  6  6  6  6  6  6  8  8  8  8  8  8  8  8  8  8  8  8  8  4  4  4  4  4  4  4  4  4  4  4  4  4
				 6  6  6  6  6  6  6  6  6  6  6  6  6  8  8  8  8  8  8  8  8  8  8  8  8  8  4  4  4  4  4  4  4  4  4  4  4  4  4
				 6  6  6  6  6  6  6  6  6  6  6  6  6  8  8  8  8  8  8  8  8  8  8  8  8  8  4  4  4  4  4  4  4  4  4  4  4  4  4
			</Textures>
		</Layer>
		<Layer>
			<Textures>
				28 21 21 21 21 21 21 21 21 21 21 21 22 28 21 21 21 21 21 21 21 21 21 21 21 22 20 13 13 13 13 13 13 13 13 13 13 13 14
				27 -1 -1 -1 -1 -1 -1 -1 -1 -1 -1 -1 25 27 -1 -1 -1 -1 -1 -1 -1 -1 -1 -1 -1 25 19 -1 -1 -1 -1 -1 -1 -1 -1 -1 -1 -1 17
				27 -1 -1 -1 -1 -1 -1 -1 -1 -1 -1 -1 25 27 -1 -1 -1 -1 -1 -1 -1 -1 -1 -1 -1 25 19 -1 -1 -1 -1 -1 -1 -1 -1 -1 -1 -1 17
				27 -1 -1 -1 -1 -1 -1 -1 -1 -1 -1 -1 25 27 -1 -1 -1 -1 -1 -1 -1 -1 -1 -1 -1 25 19 -1 -1 -1 -1 -1 -1 -1 -1 -1 -1 -1 17
				27 -1 -1 -1 -1 -1 -1 -1 -1 -1 -1 -1 25 27 -1 -1 -1 -1 -1 -1 -1 -1 -1 -1 -1 25 19 -1 -1 -1 -1 -1 -1 -1 -1 -1 -1 -1 17
				27 -1 -1 -1 -1 -1 -1 -1 -1 -1 -1 -1 25 27 -1 -1 -1 -1 -1 -1 -1 -1 -1 -1 -1 25 19 -1 -1 -1 -1 -1 -1 -1 -1 -1 -1 -1 17
				24 23 23 23 23 23 23 23 23 23 23 23 26 24 23 23 23 23 23 23 23 23 23 23 23 26 16 15 15 15 15 15 15 15 15 15 15 15 18
				28 21 21 21 21 21 21 21 21 21 21 21 22 20 13 13 13 13 13 13 13 13 13 13 13 14 20 13 13 13 13 13 13 13 13 13 13 13 14
				27 -1 -1 -1 -1 -1 -1 -1 -1 -1 -1 -1 25 19 -1 -1 -1 -1 -1 -1 -1 -1 -1 -1 -1 17 19 -1 -1 -1 -1 -1 -1 -1 -1 -1 -1 -1 17
				27 -1 -1 -1 -1 -1 -1 -1 -1 -1 -1 -1 25 19 -1 -1 -1 -1 -1 -1 -1 -1 -1 -1 -1 17 19 -1 -1 -1 -1 -1 -1 -1 -1 -1 -1 -1 17
				27 -1 -1 -1 -1 -1 -1 -1 -1 -1 -1 -1 25 19 -1 -1 -1 -1 -1 -1 -1 -1 -1 -1 -1 17 19 -1 -1 -1 -1 -1 -1 -1 -1 -1 -1 -1 17
				27 -1 -1 -1 -1 -1 -1 -1 -1 -1 -1 -1 25 19 -1 -1 -1 -1 -1 -1 -1 -1 -1 -1 -1 17 19 -1 -1 -1 -1 -1 -1 -1 -1 -1 -1 -1 17
				27 -1 -1 -1 -1 -1 -1 -1 -1 -1 -1 -1 25 19 -1 -1 -1 -1 -1 -1 -1 -1 -1 -1 -1 17 19 -1 -1 -1 -1 -1 -1 -1 -1 -1 -1 -1 17
				24 23 23 23 23 23 23 23 23 23 23 23 26 16 15 15 15 15 15 15 15 15 15 15 15 18 16 15 15 15 15 15 15 15 15 15 15 15 18
				20 13 13 13 13 13 13 13 13 13 13 13 14 20 13 13 13 13 13 13 13 13 13 13 13 14 20 13 13 13 13 13 13 13 13 13 13 13 14
				19 -1 -1 -1 -1 -1 -1 -1 -1 -1 -1 -1 17 19 -1 -1 -1 -1 -1 -1 -1 -1 -1 -1 -1 17 19 -1 -1 -1 -1 -1 -1 -1 -1 -1 -1 -1 17
				19 -1 -1 -1 -1 -1 -1 -1 -1 -1 -1 -1 17 19 -1 -1 -1 -1 -1 -1 -1 -1 -1 -1 -1 17 19 -1 -1 -1 -1 -1 -1 -1 -1 -1 -1 -1 17
				19 -1 -1 -1 -1 -1 -1 -1 -1 -1 -1 -1 17 19 -1 -1 -1 -1 -1 -1 -1 -1 -1 -1 -1 17 19 -1 -1 -1 -1 -1 -1 -1 -1 -1 -1 -1 17
				19 -1 -1 -1 -1 -1 -1 -1 -1 -1 -1 -1 17 19 -1 -1 -1 -1 -1 -1 -1 -1 -1 -1 -1 17 19 -1 -1 -1 -1 -1 -1 -1 -1 -1 -1 -1 17
				19 -1 -1 -1 -1 -1 -1 -1 -1 -1 -1 -1 17 19 -1 -1 -1 -1 -1 -1 -1 -1 -1 -1 -1 17 19 -1 -1 -1 -1 -1 -1 -1 -1 -1 -1 -1 17
				16 15 15 15 15 15 15 15 15 15 15 15 18 16 15 15 15 15 15 15 15 15 15 15 15 18 16 15 15 15 15 15 15 15 15 15 15 15 18
				20 13 13 13 13 13 13 13 13 13 13 13 14 20 13 13 13 13 13 13 13 13 13 13 13 14 20 13 13 13 13 13 13 13 13 13 13 13 14
				19 -1 -1 -1 -1 -1 -1 -1 -1 -1 -1 -1 17 19 -1 -1 -1 -1 -1 -1 -1 -1 -1 -1 -1 17 19 -1 -1 -1 -1 -1 -1 -1 -1 -1 -1 -1 17
				19 -1 -1 -1 -1 -1 -1 -1 -1 -1 -1 -1 17 19 -1 -1 -1 -1 -1 -1 -1 -1 -1 -1 -1 17 19 -1 -1 -1 -1 -1 -1 -1 -1 -1 -1 -1 17
				19 -1 -1 -1 -1 -1 -1 -1 -1 -1 -1 -1 17 19 -1 -1 -1 -1 -1 -1 -1 -1 -1 -1 -1 17 19 -1 -1 -1 -1 -1 -1 -1 -1 -1 -1 -1 17
				19 -1 -1 -1 -1 -1 -1 -1 -1 -1 -1 -1 17 19 -1 -1 -1 -1 -1 -1 -1 -1 -1 -1 -1 17 19 -1 -1 -1 -1 -1 -1 -1 -1 -1 -1 -1 17
				19 -1 -1 -1 -1 -1 -1 -1 -1 -1 -1 -1 17 19 -1 -1 -1 -1 -1 -1 -1 -1 -1 -1 -1 17 19 -1 -1 -1 -1 -1 -1 -1 -1 -1 -1 -1 17
				16 15 15 15 15 15 15 15 15 15 15 15 18 16 15 15 15 15 15 15 15 15 15 15 15 18 16 15 15 15 15 15 15 15 15 15 15 15 18
				20 13 13 13 13 13 13 13 13 13 13 13 14 20 13 13 13 13 13 13 13 13 13 13 13 14 20 13 13 13 13 13 13 13 13 13 13 13 14
				19 -1 -1 -1 -1 -1 -1 -1 -1 -1 -1 -1 17 19 -1 -1 -1 -1 -1 -1 -1 -1 -1 -1 -1 17 19 -1 -1 -1 -1 -1 -1 -1 -1 -1 -1 -1 17
				19 -1 -1 -1 -1 -1 -1 -1 -1 -1 -1 -1 17 19 -1 -1 -1 -1 -1 -1 -1 -1 -1 -1 -1 17 19 -1 -1 -1 -1 -1 -1 -1 -1 -1 -1 -1 17
				19 -1 -1 -1 -1 -1 -1 -1 -1 -1 -1 -1 17 19 -1 -1 -1 -1 -1 -1 -1 -1 -1 -1 -1 17 19 -1 -1 -1 -1 -1 -1 -1 -1 -1 -1 -1 17
				19 -1 -1 -1 -1 -1 -1 -1 -1 -1 -1 -1 17 19 -1 -1 -1 -1 -1 -1 -1 -1 -1 -1 -1 17 19 -1 -1 -1 -1 -1 -1 -1 -1 -1 -1 -1 17
				19 -1 -1 -1 -1 -1 -1 -1 -1 -1 -1 -1 17 19 -1 -1 -1 -1 -1 -1 -1 -1 -1 -1 -1 17 19 -1 -1 -1 -1 -1 -1 -1 -1 -1 -1 -1 17
				16 15 15 15 15 15 15 15 15 15 15 15 18 16 15 15 15 15 15 15 15 15 15 15 15 18 16 15 15 15 15 15 15 15 15 15 15 15 18
			</Textures>
		</Layer>
	</Layers>
</Map>